' ' ' ' ' ' ' ' ' ' ' ' ' ' ' ' ' ' ' ' ' ' ' ' ' ' ' ' ' '
' ' ' ' ' W3W2W2W2W2W2W2W2W2W2W2W2W2W2W2W2W2W2W2W1' ' ' ' '
' ' ' ' ' W4X3X2X2X2X2X2X2X2X2X2X2X2X2X2X2X2X2X1W0' ' ' ' '
' ' ' ' ' W4X4` ` ` ` ` ` ` ` ` ` ` ` ` ` ` ` X0W0' ' ' ' '
' ' ' ' ' W4X4` ` ` ` ` ` ` ` ` ` ` ` ` ` ` ` X0W0' ' ' ' '
' W3W2W2W2WfX4` ` ` ` ` ` ` ` ` ` ` ` ` ` ` ` X0WdW2W2W2W1'
' W4X3X2X2X2Xf` ` ` ` ` ` ` ` ` ` ` ` ` ` ` ` XdX2X2X2X1W0'
' W4X4` ` ` ` ` ` ` ` ` ` ` ` ` ` ` ` ` ` ` ` ` ` ` ` X0W0'
' W4X4` ` ` ` ` ` ` ` ` ` ` ` ` ` ` ` ` ` ` ` ` ` ` ` X0W0'
' W4X4` ` ` ` ` ` ` ` ` ` ` ` ` ` ` ` ` ` ` ` ` ` ` ` X0W0'
' W4X4` ` ` ` ` ` ` ` ` ` ` ` ` ` ` ` ` ` ` ` ` ` ` ` X0W0'
' W4X4` ` ` ` ` ` ` ` ` ` CfCfCfCf` ` ` ` ` ` ` ` ` ` X0W0'
E1` ` ` ` ` ` ` ` ` ` ` ` CfCfCfCf` ` ` ` ` ` ` ` ` ` X0W0'
E1` ` ` ` ` ` ` ` ` ` ` ` CfCfCfCf` ` ` ` ` ` ` ` ` ` X0W0'
' W4X4` ` ` ` ` ` ` ` ` ` CfCfCfCf` ` ` ` ` ` ` ` ` ` X0W0'
' W4X4` ` ` ` ` ` ` ` ` ` ` ` ` ` ` ` ` ` ` ` ` ` ` ` X0W0'
' W4X4` ` ` ` ` ` ` ` ` ` ` ` ` ` ` ` ` ` ` ` ` ` ` ` X0W0'
' W4X4` ` ` ` ` ` ` ` ` ` ` ` ` ` ` ` ` ` ` ` ` ` ` ` X0W0'
' W4X4` ` ` ` ` ` ` ` ` ` ` ` ` ` ` ` ` ` ` ` ` ` ` ` X0W0'
' W4X5X6X6X6X9` ` ` ` ` ` ` ` ` ` ` ` ` ` ` ` XbX6X6X6X7W0'
' W5W6W6W6W9X4` ` ` ` ` ` ` ` ` ` ` ` ` ` ` ` X0WbW6W6W6W7'
' ' ' ' ' W4X4` ` ` ` ` ` ` ` ` ` ` ` ` ` ` ` X0W0' ' ' ' '
' ' ' ' ' W4X4` ` ` ` ` ` ` ` ` ` ` ` ` ` ` ` X0W0' ' ' ' '
' ' ' ' ' W4X5X6X6X6X6X6X6X6X6X6X6X6X6X6X6X6X6X7W0' ' ' ' '
' ' ' ' ' W5W6W6W6W6W6W6W6W6W6W6W6W6W6W6W6W6W6W6W7' ' ' ' '
' ' ' ' ' ' ' ' ' ' ' ' ' ' ' ' ' ' ' ' ' ' ' ' ' ' N0N1N2N3
